WWWWWWWWWWWWWWWWWWWW
W     . . . . . .  W
W         WWWWWW   W
W   WWWW       W . W
W   W        WWWW .W
W WWW  WWWWW    E  W
W . W     W W      W
W . W .   W   WWW WW
W.  WWW WWW E W W  W
WWW   W   W   W W  W
WWW   W   WWWWW W  W
W W      WW    E   W
W W   WWWW   WWW   W
WS    WF   E   W   W
WWWWWWWWWWWWWWWWWWWW
